{
  "spritemap" : "field",
  "area" : [
    [1, 1, 1, 1, 1, 1, 8, 9, 10,  1,  1,  1,  1,  1,  1],
    [1, 1, 1, 1, 1, 1, 8, 9, 10,  1,  1,  1,  1,  1,  1],
    [1, 1, 1, 1, 1, 1, 8, 9, 10,  1,  1,  1,  1,  1,  1],
    [1, 1, 1, 1, 1, 1, 8, 9, 10,  1,  1,  1,  1,  1,  1],
    [1, 1, 1, 1, 1, 1, 8, 9, 10,  1,  1,  1,  1,  1,  1],
    [1, 1, 1, 1, 1, 1, 8, 9, 10,  1,  1,  1,  1,  1,  1],
    [1, 1, 1, 1, 1, 1, 8, 9,  7,  5,  5,  5,  5,  5,  5],
    [1, 1, 1, 1, 1, 1, 8, 9, 9, 9, 9, 9, 9, 9, 9],
    [1, 1, 1, 1, 1, 1, 8, 9, 9, 13, 13, 13, 13, 13, 13],
    [1, 1, 1, 1, 1, 1, 8, 9, 10,  1,  1,  1,  1,  1,  1],
    [1, 1, 1, 1, 1, 1, 8, 9, 10,  1,  1,  1,  1,  1,  1],
    [1, 1, 1, 1, 1, 1, 8, 9, 10,  1,  1,  1,  1,  1,  1],
    [1, 1, 1, 1, 1, 1, 8, 9, 10,  1,  1,  1,  1,  1,  1],
    [1, 1, 1, 1, 1, 1, 8, 9, 10,  1,  1,  1,  1,  1,  1],
    [1, 1, 1, 1, 1, 1, 8, 9, 10,  1,  1,  1,  1,  1,  1]
  ]
}
